22 16
████████████████
█              █
████ ██████ ██ █
█    █         █
████████ ███████
█              █
█ ████████████ █
█ █    █ █     █
█ █ █    ███████
█ █ █ █        █
█   █   ███ █  █
█ ███████ █    █
█         █ █  █
██████████████ █
█              █
█ ██████████████
█     █    █   █
█████     ██ █ █
█   █████    █ █
█ ██ █  ██████ █
█              █
████████████████
2 2
19 4